#######################
#.....................#
#.....................#
#.....................#
#.....................#
#SSSSSS...............#
#.....................#
#.....................#
#.....................#
#.....................#
#.....................#
#.....................#
#######################
